###################E#
# #         #       #
# # ####### # #######
# # #     # #       #
# # ##### # ### ### #
# #       # # #   # #
# ####### # # ##### #
#     #   # #   #   #
# ### # ### ### # # #
#   # # # # #   # # #
# # ### # # # ### # #
# #   #   #   #   # #
# ### ### ##### #####
# #     #     # #   #
# # ### ##### # # # #
# # #     #   #   # #
# # ####### ####### #
# #   #     #       #
# ### # ####### ### #
#   #           #   #
#################S###
