#########E###################
# #       #     #           #
# # ### # # ### # ##### # # #
#   # # # # # # # #   # # # #
# ### # # # # # ### # ### # #
#     # # # # #     # #   # #
####### # # # ####### # ### #
#       #   #       # # # # #
# ############### # # # # # #
# #             # # # # # # #
# # ########### # # # # # # #
# # #           # # # # # # #
### ### ##### ### # # # # # #
#     # #   #     # # # # # #
# ### ### # ####### # # # # #
# # # #   #       # # # # # #
# # # # ######### ### # # # #
#   #           #       #   #
#########S###################
