#E###########################
#       #   #     #     #   #
##### ### # # ### # # ### # #
#     #   #   # #   #     # #
# ### # ####### ########### #
#   # #   #       #       # #
# # ##### ##### # # ### ### #
# #       #   # #   #   #   #
# ######### # # ##### ### # #
#   #       # # #   #   # # #
### ##### ### # # # ### # ###
# # #     # #   # # #   #   #
# # # ##### ### ### ##### # #
# # # #   #     # #     # # #
# # # ### # ##### ##### ### #
#   # #   # #     #   #     #
# ### # ### ### # # # #######
#     #         #   #       #
#########S###################
